Ntrk1	Favorable
Ntrk2	Unfavorable
Mycn	Unfavorable
Alk	Unfavorable
Brca1	Unfavorable
Mki67	Cell_cycle
Lgr5	Differentiation
Dlk1	Differentiation
Prom1	Differentiation
Isl1	Adrenergic
Hand1	Adrenergic
Dbh	Adrenergic
Phox2b	Adrenergic
Chgb	Adrenergic
Th	Adrenergic
Prrx1	Mesenchymal
Dcn	Mesenchymal
Pdgfrb	Mesenchymal
Htr3a	Bridge
Cartpt	Sympathetic
Sox10	Glial
S100b	Glial
Tek	Endothelial
Pecam1	Endothelial
Epas1	Hypoxia
Cldn11	Precursor
Chrna7	Precursor
